###########################
#                         #
## ################### ## #
## ##       X#     ### ## #
## ## ############ ### ## #
## ##    #           # ## #
## ## ##   ######### #  # #
## ###############   # ## #
##               ## #  ##S#
#  ################ #######
# # ## ###          ###   #
# # ## ######### #####  ###
# # ## ### #           ## #
# #        ########### ## #
# ########             ## #
#          ###########    #
###########################